nineToEleven,elevenToOne,oneToThree,threeToFive,Predicted_nineToEleven,Predicted_elevenToOne,Predicted_oneToThree,Predicted_threeToFive
1,1,0,0,1,0,1,0
0,0,1,1,1,0,1,1
0,1,1,1,0,1,0,1
1,1,1,0,0,1,0,1
1,0,0,0,0,1,0,0
1,0,1,1,0,0,1,0
0,0,0,1,0,1,0,1
1,0,1,0,0,0,1,1
0,0,0,0,1,0,0,0
0,0,0,1,0,0,1,1
0,0,1,0,0,0,0,0
1,0,1,0,0,1,0,1
0,0,0,0,0,0,1,0
0,0,1,1,0,1,1,1
1,0,0,0,1,0,0,0
1,1,1,1,0,1,1,1
0,1,1,1,0,0,0,1
0,1,0,0,1,0,1,0
0,0,1,0,1,0,1,0
0,0,1,1,1,0,0,1
0,1,1,1,0,1,0,0
0,1,0,0,0,0,1,0
0,1,0,1,1,1,1,0
1,1,0,1,1,1,1,1
1,0,0,0,0,1,1,0
1,1,1,0,0,0,0,1
1,0,1,0,0,0,1,0
0,1,0,0,1,0,1,1
0,1,1,1,0,1,1,0
0,0,0,0,0,0,1,1
0,1,1,1,1,1,0,0
1,0,0,0,1,1,1,0
0,1,1,0,0,1,1,1
1,1,0,0,0,0,0,1
1,1,1,1,0,1,0,1
0,1,1,0,0,1,1,0
1,1,0,1,0,1,1,1
1,0,0,1,0,1,0,1
1,0,1,1,1,0,1,1
1,1,0,1,1,1,0,0
0,1,1,1,1,1,1,0
1,0,1,1,1,0,1,0
1,1,1,0,1,0,0,1
1,1,1,1,0,1,1,1
0,1,0,0,0,0,1,0
1,1,0,1,0,0,1,0
0,1,0,1,1,1,1,0
0,1,0,0,1,0,1,1
0,0,1,0,0,1,1,0
1,0,0,1,1,1,1,1
1,1,0,1,1,1,1,1
0,1,1,0,1,1,0,0
0,1,0,0,1,1,0,0
0,0,0,0,1,0,0,0
1,0,1,0,0,1,1,1
1,1,1,0,1,0,0,0
1,1,1,1,0,1,1,0
1,0,1,0,1,1,0,1
0,0,0,1,0,0,1,0
1,0,0,1,0,0,0,1
1,0,1,1,0,0,0,1
1,0,1,0,1,0,0,0
0,1,1,0,0,1,1,0
1,0,1,1,1,1,1,1
0,0,1,0,0,1,1,0
0,1,0,1,1,0,0,0
1,0,0,1,1,1,0,0
0,0,0,1,1,1,1,0
0,1,1,1,0,1,1,1
1,0,0,1,1,1,0,1
0,0,1,0,0,0,1,1
0,1,1,0,0,1,1,1
0,1,1,0,1,0,0,1
1,1,1,0,1,1,1,1
0,0,1,1,1,0,0,0
1,1,0,0,1,0,1,1
0,1,0,1,0,0,1,1
1,1,0,0,1,1,1,0
